a: a, on
abad: telané
abajo: aostelé, abajiñé
abastecer: maturnar
abatimiento: traquí
abecedario: rotuñularí
abedul: yorbo
abeja: jernimachí
abismo: butrón
ablandar: sosclayar
abrasar: bengebar
abrigado: acruñao
abrigase: acruñar
abrigo: acruñé
abril: quinglé
abrir: gucarar
abrochado: atachonado
abrochar: trensar
absolver: sordicar
abuela: paparuñí, batipurí, beripapí
abuelo: batipuró, tesqueló
abultado: barial
abundancia: baribustré, sobraunchó
abundar: butembar
acá: acoí, oté
acallar: sonsonichar
acariciar: ajelar
aceite: ampió
aceituna: zetalla
acento: querrentó
aceptar: cambrar
acercar: arpujar
acertar: sinisar
acoger: ustilelar, alollar
acompañamiento: sarsalé
acompañar: sarsalar
acontecer: sinabar
acordar: engallar, ojarar
acortar: chimoquerar
acosado: ampuchao
acosar: ampuchar
acostumbrar: bedar
acotar: achinar
activo: caré
acto: goliché
actualmente: sejonía
acudir: achorgornar, catanar
acusador: bufaire
acusar: saplar
achaque: chijé
achicar: chimorrar
achicharrar: bengebar
adelantada: sujallí
adelantado: sujalé
adelantar: chirimijar
adelante: algial
adentro: enrén, urró
adherir: diñobelar
adinerada: ajandorrí
adinerado: ajandorrás
adivinadora: chuanjañí
adivinar: timujiar
admiración: tripasarí
admirar: cibar
admitir: cambrar
adoctrinar: chirijar
adolescente: chaborró
adonde: anduque
adondequiera: docambé
adorado: bujirí
adorar: bujirar
adormecer: asobar
adornar: adojar
adorno: atojo
adúltera: majelí
adulterio: majelamí
adúltero: majelé
adversario: dachimané, enormé
advertido: apusao
afable: alojé
afán: anguñó
afeitar: palabear
afeminado: ruminé
aferrar: garibear
aficionar: aquirindar
afirmar: atrojipar
afligir: soronjiar
aflijida: soronjí
aflijido: soronjé
afuera: bartrabé
agachada: alchuchí
agachado: alchuché
agachar: sobachatar
agarrar: sinastrar, trujipar
agitanada: calloquí
agitanado: callocó
agonía: jirabé
agosto: querosto
agraciar: sardañar
agrio: soró
agua: pañí
aguantar: argurar
aguardar: agarabar
aguardiente: pañicarí
águila: guichito
aguja: jutiá
ahí: aoplé
ahogada: buyí
ahogado: buyó
ahogar: amular
ahora: aocana, acaná
ahorcada: borní
ahorcado: borné
ahorcar: bornar
ahorrar: orrijar
aire fresco: jil
aire: barbal
airear: barbanar
ajos: siris
ajustado: chomí
ajustar: chomar
ala: ondina
alambre: frullá
alameda: arberú
álamo: ondinamo
alargar: alachinguar, astar
alba: claricó
albañil: randiñaró
albaricoque: chirijé
alcachofa: cañipumí
alcahueta: sobajañí
alcahuete: sobajanó
alcalde: basqueró
alcaldía: bascañí
alcanzar: alcorabisar
alcoba: isba
alcornoque: richanjé
alegrar: asaselar, lalar
alegre: sardañoy, alendoy
alegría: sorí, alalá
alejar: sonajar
alerta: acán
alfarero: bujuliné
alfiler: chingabí, cofrí
algo: gulú
algodón: trusí
alguna: cormuñí
alguno: cormuñó
aliento: arispañén, soschí
aliño: alijipí, atojo
aljibe: fufú
alma: ylo
almacén: uchusén
almorzar: bufetear
alquilar: arlipuchar
alquiler: arlipuchó
altar: chalorgar
altísima: uschí
altísimo: uschó
alto: sasto
altura: otalpe
alzar: ustilar
allá: andolaye, aotal
allanar: arosipar
allí: aoter, oté
amancebarse: pansiberarse
amanecer: jachivar
amante: coima
amar: camelar
amargar: budiar
amariconado: eriñé
amarilla: batacolí
amarillo: batacolé
amasar: mulillar
amén: anaranía
amenaza: gajesa
amiga: monrí
amígdala: yacamí
amigo: monró
amistad: liga
amparar: bomborar, brequenar
ancha: anllí
andar: pirar
ángel: manfariel
anguila: trujillí
angustia: berrochi, chucarrí
angustiar: emposunar
anhelo: anguñó
anillo: anguí, chuquí
animación: soschí
animada: orchiquiñí
animado: orchiquinó
animal: bustronel
ánimo: chiporró
ano: bul
anoche: arachí
anochecer: nerachilar
anotar: randar
ansia: gramí
ansiosa: vaquí
ansioso: vacó
ante: angella
antepasada: sumaquí
antepasado: sumacó
anterior: angelí
antes: gres
antesala: sulopia
antigua: surrí
antigüedad: purijé
antiguo: surré
antojo: ancrí
antorcha: mermellín
añadir: anadiar, nejabar
añeja: arranfí
añejo: arranflé
año: breje, dané
apagar: babiñar, bedelar
apalabrar: caremar
apalear: bastelar, chaltrar
aparato: majoré, monjaré
aparecer: bichalar
aparecido: dirló
apegado: diñovó
apelación: bertelarí
apelar: bertelar
apellido: liruqué
apero: ambrí
apestar: funguelar
apestosa: fungallí
apestoso: fungalé
apetecer: angelar
apetito: ángelo, boqué, jallipí
apio: jambú
aplazar: macarar
apocada: bubiñí
apocado: bubiñó
apodo: avernaó
aporrear: chaltrar
apreciada: jellí
apreciado: jeló
apreciar: jelar
aprender: sisastrar, trequejenar
apresar: trincar
apretado: grasnó
apretar: trinquelar
aprieta: trinquelo
aprobación: lujoñí
aprobar: lujoñar
apropiar: menribar
apuesta: lijañí
apuntalar: uchular
apuntar: uchar
apurar: escarfilar
apuro: juló
aquel: andoba
aquél: ocola
aquella: andolaya
aquélla: ocola
aquellas: asirías
aquello: ocolo
aquellos: asirías
aquí: acoí, atocé
araña: arica
arañar: arisojar, ñaicar
arañazo: arisojón
arar: astrujar
arbitrar: argirar
arbitrio: arjiní
árbol: arberuqué, erulé
arbolado: arberú
arbusto: arluchí
arca: arcojuñí, tajuñí
arcángel: arjorí
arco: alcurí
arcón: yestaró
archivo: astelí
ardiente: danduló
ardor: arrebojar
arena: ardombardí
argolla: cacobí
arma: aroschí
aro: alcurí
aroma: bue
arpa: ari
arraigado: amuñejao
arraigo: amuñejo
arrancar: arsujar
arrastrado: arjulipé
arrastrar: arjulipar
arrebato: arjulejú
arreciar: arrebojar
arreglado: chitó
arreglar: chitar
arreglo: arquisimí
arremangar: rejunar
arrepentimiento: arrebujaró
arrepentirse: arrebujirse
arrestar: arinatrar
arresto: arinatro
arriar: arrelenar
arrimar: arpujar
arrodillar: arriciar
arrogancia: bardudiñí
arrojado: arquisijí
arrojar: arquisijar
arropar: alfarjar
arroz: arcopicho
arruga: argostín
arruinada: arruchí
arruinado: arruché
arteria: trajata
artículo: artribulí
artillería: arbijundí
asado: arminé, asminé
asaltar: asalmuñar, sicobar
asalto: asalmuñí
asamblea: beia
asar: asminar
aseada: alipí
aseado: alpiadó
asear: alipiar
asegurar: atrojipar
aseo: alipipén
asesinar: churinar
asesino: ardují, churrinaró
asesor: agualó
asesoría: agualí
así: andiar, atiar
asiento: abestiqué, agentive
asir: sinastrar, trujipar
asistencia: asiapí
asistir: andigar
asno: buchinogue
asociado: acatao
asociar: acatar
asomar: chiprar
asombrar: asordar, tripasar
asombro: asordú
aspaviento: aribán
aspirar: arispar
asquerosa: jindí
asqueroso: jindó
astilla: arica
astro: taripé
astróloga: taripí
astrología: taripén
astrólogo: taripó
astucia: albirijí, arcarabí
asustada: dandullí
asustado: dandulé
atalaya: orjirlé
atar: ñaquibar
ataúd: gestarí
atención: acán
atender: diquelar
atenerse: aterelarse
atento: emposumó
ático: currandea
atinar: sinisar
atormentar: acharar
atrás: palal
atropellar: catar
audiencia: benseñí, sundiné
aumentar: arrebojar
aunque: ansos
autoridad: bujerí
avara: arrajuñí
avaricia: arrají
avariciosa: vaquí
avaricioso: vacó
avaro: arrajunó
avasallar: achangar
avena: lardorí
avenida: sisní
aviada: chití
avión: arrigé
avisado: apusao
avispa: arsoñí
ay: isna
ayer: acheté
ayuda: ajilé
ayudar: agiler
ayunar: arrestrejalar
ayuntamiento: armorojorí
azabache: ajiesiné
azafrán: jopiní
azahar: ajilí
azotea: currandea
azúcar: galuchí, ullí
azucarado: galuchunú
azufre: juré
azul: jul
azulado: julé
azulejo: gobo
azuzena: gildí
baba: bajilí, chiotá
bacalao: juribañí
báculo: bateró
bachiller: baniché
bachillerato: banichería
badajo: batelé
bailar: quelar
bailarín: quelararó
bailarina: quelararí
baile: quelo
bajo: bajiné
bala: jurdia
balanza: pasanta
balcón: felichó
balsa: balaja
bálsamo: baltimutí
ballena: bancotilla
banca: bansaquí
banco comercial: quejeña
banco: agentive, bestelé
bandada: butijullí
bandera: nagira
banderillear: bitigiar
bandido: bajiloné
banqueta: gallipén
banquete: busonquí
bañar: barmejiar
baño: barmejí
baraja: bisparaja
barandilla: buspijirí
bárbara: burjachiquí
bárbaro: burjachiqué
barbas: chones
barbecho: burchiqué
barbería: burquechí
barbero: burquechó
barca: berdí
barco: berdó
barón: bunejú
barra: buja
barranco: bujarrí
barrena: bascurrí
barrendera: burjamarí
barrendero: burjamaró
barrer: burjamar
barriga: po
barrio: bijuca, ulague
barro: bujulí, chiqué
barullo: garata
base: pardí
basta: brejelí, dosta
bastante: barsamiá, dosta
bastar: brejelar
bastardo: burracó
basto: brejeló
bastón: bujucó
basura: anguitarri, buñigoní
basurero: furgoñí
batalla: burolla
bateria: balijí
batir: baliar
bautismo: muchobelaró
bautizar: muchobelar
beata: manjarí
beato: manjaró
bebé niña: chinorrí
bebé niño: chinorré
becerra: bechuñí
becerro: chajurú
bella: balgisí
belleza: orchirí
bello: balgí
bellota: birtrujimí, berjivia
bendecir: majarar
bendita: manjarí
bendito: manjaró
berenjena: borroñona
berro: yeslú
berza: barriñí
besar: chumendiar, chupendar
beso: chumendo
bestia (animal): bustajú
bestia (persona): gra
betún: busjimé
bien: mistó
bigote: bericobé
billete: bindoy
bisiesto: quiungadoy
bizcocho: bijutoy
blanquear: bornabar
blasfemia: solajaí, zermaña
boca: muí
bocado: bornó
bodega: bambanicha
bodegón: tallón
bofetada: chomidiñí
bofetón: chomidiñó
bollo: gorvio
boquete: jebé
borracha: matagarní
borrachera: matipén
borracho: matagarnó
borrico: buchinogue
bosque: toberjelí
bota: droba
bote: bují
botella: menderí, mollate
brazo: murciá
breva: beu
brincar: salmuñar
brinco: salmuñí
brindar: terquelar
broma: baya
bronce: asispolé
bruja: timujañí
brujo: timujanó
buenaventura: bají
bueno: mistó
buey: burú
bufete: cachidí
burda: brejelí
burdo: brejeló
burra: greñí
burro: grel
buscón: orundó
buscona: orundañí
busto: bucratón
caballería: gra
caballero: elay
caballo: grasté
cabaña: ocajanaicha
cabello: bal
cabellos: airés
cabeza de familia: brojeró
cabeza: jeró, tujoi
cabra: bruñí
cabrito: bruñilló
cabrón: jincalé
cada: cala, cata
cadena: beriga
cadera: palomí
caer: opelar
cagar: jiñar
cajetilla: tajuñí
calabacín: pondolé
calabaza: pondón
calbozo: pandibó
caldera: cascarabí
calderilla: flima
caldo: zumí
calisén: muerte
cáliz: bada
caliza: urregiche
calor: jacha
calumnia: mareal
calva: pilví
calzado: calcorró, tirajaiché
calzoncillos: baluñé
callar: sonsibelar
calle: ulicha, bola
cama: piltra, cheripén
camarada: candón
cambiar: binelar, gardar
cambio: garda, paurripén
camello: brote
caminar: pirar
camino: andró, dron
camisa: caroma, gasté
campamento: chater
campana: bagandí, bayandí
campo: berjalí
cana: balpariñó
canal: canulí
canasta: bajirina
canción: guiyabó, singa
candado: canduio
cándido: longuí
candil: desqueró
cangrejo: ajá
cantador: gillabaor
cantadora: gillabaora
cantar: gibelar
cántaro: coró
canto: bar
caña: balsamí, salsuchó
cañada: terriclé
cáñamo: ziro
cañón: bruchardó
capa: agüela
capado: mandelón
capilla: maramucha
capital: foro
capricho: ancrí
cara: bulmuñí
caracol: norical
carbón: barbado
cárcel: estarí
cardenal: eraipolalané
cardo: carro
carecer: nabelar
cargador: castraberó
cargar: cartrabar, castrabar
caricia: rumendí
cariño: jelí
carnaval: antruejó
carnero: bracó, jenlí
carnicero: macarunó
carrera: plastanía
carta: lía
cartel: bique
cartera: lel
cartero: palmenteró
casa: que
casada: romí
casado: rom
casamiento: romandiñó
casar: romandiñar
casino: boliche
casta: ratí
castaña: espivia
castigar: barandar
castigo: sanisco
Castilla: Castumba
castillo: silisqué
castrado: mandelón
católica: burdórica
católico: burdórico
catorce: ostardequé
causa: bansalé, bausalé
cautiva: utildí
cautivo: utildé
cavidad: furnia
caza: cholarí
cazador: calaroné
cazar: cholarar
cazuela: claví
cebada: chor
cebolla: esporborí
cejas: simbrés
celador: udorilé
celadora: udoriñí
celos: achares
celoso: acharao
cenicienta: flachayí
ceniciento: flachay
ceniza: flacha
cepo: rapa
cera: jerní
cerca: apajé
cercado: yustiqué
cercano: sumparal
cerco: alcurí
cerda: balí
cerdo: baliché
cereza: quirsijimí
cerilla: candimumelí
cerradura: pandarí
cerrojo: angrumó
ciega: chindí
ciego: chindó
cielo: charó, otalpe
cien: gres
ciencia: chancrí, chanerí
cierta: chindiñí
cierto: chindinó
ciervo: bajilacha
cigarrillo: truja
cigarro: chubaló, trujandí
cigüeña: altacoya
cimiento: pardí
cinco: panché
cincuenta: panchardí
cintura: sosinga
cinturón: sustiguí
ciruela: quillaba
ciudad: ancha, foro
ciudadano: foroano
clavar: carfialar
clavel: brocujilé
clavo de especia: madoy
clavo: cascalé, sincarfial
clemente: canroné
clérigo: eraipó, telloré
cobre: orosqué
cocer: pejuchar
cocina: quinquina
cocinera: quinquinibí
cocinero: quinquinobó
coche: beré
coger: sinastrar, trinquelar, trujipar
coitar: apirabar, chingar
coja: languí
cojera: langarí
cojo: langó
col: sojie
cola: mamporí
colcha: uchacarisa
colchón: pondoné
colectividad: plastañí
colegio: manporegio
cólera: ajurjuñí
colérico: ajurjuñó
colocar: sujelar
color: llerel
collar: corrallá
comadre: quiribí
combativa: chinganarí
combativo: chinganaró
comedia: arasta
comenzar: chistelar
comer: jalar, jamar
comerciar: paruguelar
cómica (actriz): parí
cómico (actor): paró
comida: jallipén
comiquería: paripé
cómo: sasta, sata, sosqué
como: ta
compadre: quiribó
compañero: quiliberó
compasión: canrea
compasivo: canroné
complacer: alendelar
complacida: alendayí
complacido: alendeló
componer: adojar
comprender: chanelar
comunión: erañí
con: sar, sarsa, sat
concurrir: catanar
condenar: saplar
condimento: alijipí
conducir: lanelar
conejo: jojoí
confesar: unumincar
confesión: unuminqué
confianza: bonansible, ujaripén
confiar: bonansilar
congoja: angujá
congregar: catenear
conjeturar: bajuchanar
conmigo: mangué, sarmenda
conocer: chanelar, entrevar
conocimiento: siscababén
conseguir: alcorabisar
consejero: agualó
consentir: mecar
conservar: ujarelar
consuelo: paratató
contar: jinar
contestación: brudila
contienda: billa
contigo: sartucue
contrario: dachimanú
contratro: randiñipén
contribución: costiñí
conversación: araquerabén, chamullo
conversar: chamullar
coño: chuquí
copa: gachaté
copia: gachaplá
coraje: berrí, orchiquén, sislí
coral: meridén
Corán: Alculalá
corazón: brijilí, calochí
corchete: durlín
cordel: geliche
cordera: braquillí
cordero: braquilló
cordón: llundró
cornear: serear
corona: cusaña
corral: angerí, mericlén
correr: najar, chapescar
corta: chimí, tiquiñí
cortadura: chinarí
cortar: chinar
corte: chirdé
cortés: alojé
corteza: orují
cortijo: cosqué
corto: chimó, tiquiño
cosa: buchí
coser: sibar
costilla: pajoría
costosa: murñí
costoso: murnó
costumbre: beda
costura: sibararí
coyuntura: reblantequeré
credo: panchabó
creer: panchabar
criada: lacrí, sucarrí
criado: lacró, sucarró
criador: parbaraor
criar: parbarar
criatura (niña): parbarí
criatura (niño): chinoró
cristiana: bordelí
cristiano: bordelé
crucificar: trijular
cruz: trejú
cuál: sos
cuan: quichi
cuándo: bur
cuando: bus, pur
cuanto: sos
cuarenta: ostar
cuaresma: ostarinda
cuarta: ostarí
cuarto: queli
cuatro: sista
cubrir: ucharar
cuchara: breca
cucharón: berteró
cuchillo: churí
cuello: garló, querló
cuento: jinobla
cuerda: rapela
cuerno: nogué
cuerpo: drupó
cuervo: currucú
cueva: turní
cuidadoso: emposumó
culebra: bulistraba
culto: lajariá
cumpleaños: chibeses
cumplir: archabar
cuño: atronjí
cura: castañí
curación: castañí
curar: chivar, sastar
chaleco: carbé
chapero: arjulipí
chaqueta: sobre
chasco: gandascó
chata: dinajua
chato: diñacllé
chimenea: sosimbó
chinche: quinquiria
chispa: muchí
chivato: chota
chopo: yorbo
chorro: inica
choza: chupano
chuleta: pajoría
chulo: gaché
chupar: chupendar
dado(cubo): diñao
dado: tarafé
danza: quelañí
danzar: quelar
dañar: caquerelar
dañina: tuyallí
dañino: tuyaló
daño: panipén
dar: diñar
de los: es
de un golpe: cataré
de veras: zimali
de: e, on
debajo: abajiñé, brostelé, ostelé
deber algo: debisar
débito: bizaura
decepción: changuí
décima: esdencibú
decir: penar
declarar: vear
dedal: sumbaló
dedo: panró
defecto: dojí
defender: brequenar
defensor: brequeneró
defensora: brequenerí
deforme: chorré
degollar: amular
dejar: mecar, mucar
del: dor
delante: angella
delator: bufaire
delgada: ziriardí
delgado: ziriardé
delicada: sorabé
delicado: sorabé
Demonio: Bengojí
demostración: abipí, dialañí
dentro: andré, enrén
deponer: entregisarar
depósito: uchusén
derecha: bustarí
derecho: bustaró
derramar: batanar
derribar: combar
derrochar: najabelar
desaparecer: najarar
descansar: desquiñar
descanso: desquiño
descender: opelar
descenso: ostelí
descolgar: deschindar
descubir: bucharar
desear: angelar
desempeño: archabaré
deseo: ángelo
desgracia: charaburrí
desgreñar: desglantar
designar: uchar
desmayo: angujá
desnuda: rechipotí
desnudo: rechipoté
desorden: garata
despedazar: debus
despedir: arquisijar
despojar: sicobar
despreciar: jirelar
después: anda
desterrar: bichardar
destierro: bicharduy
destruir: marar
desvarío: barbalé
desviar: rebucharar
desvirgar: espachilar
detener: sinabar
detrás: apalá, palal
deuda: bizaura
deudor: bizauró
deudora: bizaurí
devorar: trajelar, ustibelar
dí: pen
Diablo: Bengorré, Dengue
diadema: doscursaña
diálogo: bachijuñí
diciembre: quendebré
dichosa: zachí
dichoso: zaché
dieciocho: otordequé
diecisiete: esteredequé
diente: daní, piñó
diestro: bastaró
diez: dequé, esdén
diezmo: esdembó
difundir: voltisarar
digan: cabaliquí
digno: cabalicó
dilapidar: esparruar
diluviar: pañibarar
diluvio: pañibarí
dinero: parné
Dios: Batimují, Ostebé
diosa: debla
dique: talló
discernimiento: calambrico
diseminar: najibar
disfrutar: ozunchar
disminuir: achirdar
disponer: childar
disputa: chiaga
distrito: ullaque
dividir: aginar, aricatar
divina: timují
divino: timujó
división: aginé, aricata
DNI: atrojipú
doce: duidequé
doctor: chandé
doctrina: chirija
documento: libañí
dolencia: panipén, chijé
dolor: alangarí
dolorosa: sorallí
doloroso: soralé
domicilio: queré
domingo: duncó
dominio: arcilar
Don: Den
donaire: zardioquí
donde quieras: aduqué
dónde: sosqué
dorada: bijurí
dorado: bijuré
dormir: sobar
dos: duis
dragón: bengué
duende: mengue
dueña: yejalá
dueño: yejaló
dulce: bullán, buñé
dulzura: bullapipén
dura: sorallí
duro: soralé
echado: chitado
echar: bucharar
edicto: bujilí
ejecutar: aquerar
ejemplar: ejersilén
ejercito: argandí
el de: ye
El Señor: Elay
el ser: arat
él: alé, o
el: o, or
elevada: suca
elevado: suco
elevar: ardiñar
ella: siró, andolaya
ellas: siras
ello: acalló, andalló
ellos: andayos, junos
embarcación: berasimplín
embargo: ducaldí
emborrachar: amuchar
emborracharse: acurdarse
embuste: bulo
embustería: bulería
empadronar: jinamar
empequeñecer: chimoquerar
empinar: surdinar
en alto: upre
en donde: anduque
en todas partes: adocambé
en: an
enamorada: gachararí
enamorado: gacharao
enamoramiento: camelo
enamorar: encamelar
enana: nachequillí
enano: nachequilé
encantar: cibar
encender: urdiflar
encerrar: pandisabar
encima: upre
encina: cochoco
encontrar: alachar, berjar
encrucijada: yetrucajay
enderezar: uchubalar
enemigo: dachimanú, enormé
enero: inerín
enfadada: norunjisa
enfadado: norunjí
enfadar: norunjar
enferma: nasallí
enfermedad: merdipén, panipén
enfermera: bederí
enfermero: bederó
enfermo: nasaló
enfrente: mamuí, terquera
engaño: changuí
engendrar: abatanar
engrasar: ampielar
engullir: tapillar
enima: perso
enmendar: enagrar
enmienda: enagró
enojada: dují, ulullí
enojado: duijó, ululé
ensalada: arjañá
ensalzar: ardiñar
enseñanza: siscabañí
enseñar: siscabar
entender: chanelar
entera: teroñí
enternecer: sosclayar
entero: teroné
enterrador: tripamuló
enterramiento: archelarén
enterrar: archelar
entierro: archelo
entonar: labilar
entre: andré, enré
entresuelo: rejochiqué
enumerar: jinar
envejecido: puriandé
enviar: bichabar
envolver: argilar
época: chiró, dané
erizar: uchubalar
erizo: uchabaló
error: drunchí
eructo: taco
ésa: ocola
escalera: paupiré, yescaliche
escandalizarse: arredomarse
escándalo: cagrujé
escapada: chapescañí
escapar: najar
escarnecer: arjulipar
esclavo: gelfé
escoger: escogiselar
esconder: ucharar
escondite: bujio
escorpión: birberecho
escribiente: currialí
escribir: libanar
escrito: libañí
escritor: libanó
escritura: libanerí
escuchar: junar
escupir: chiotar
ese: andoyá
ése: ocola
esencia de las cosas: ochí
esfuerzo: esilén
eslabón: chalchibén
eso: andalló, acalló
espacio: surdán
espada: bayosa
espalda: barandía, espulví
espantar: tripasar
espantarse: acararse
espanto: dal
España: Sersé
español: sersén
española: serseñí
esparcir: najibar
espárrago: engrejerí
esparraguera: engrejera
espejo: berber
esperanza: ujaripén
esperanzas: ujararés
esperar: ujarar
espía: besaní
espina: jarrí
espinal: enrajardá
espinazo: nabato
Espíritu Vital: Ochí
espíritu: ilo, sincaí
Espíritus Malos: Bengues Chorés
Espítritu Santo: Peniché
esposa: romí
esposo: rom
esquina: esicón, sisconché
estafa: goloría
estaño: estibió
estar: sinar, socabar, quesar
estás: soscabelas
éste: andalló, acalló
este: andoba
estera: telejuñí
estercolero: furgoñí
estéril: nangué
estilar: daracar
estilo: daraco
estío: jacuno
estirada: aberdollí
estirado: aberdolé
estirar: alachinguar
esto: ocolo
estómago: ogomo
estornudar: chicatelar
estornudo: chicatelu
estrecha: trujoñí
estrecho: trujón
estrechura: trují
estrella: uchurgañí
estropajo: jalaballé
estudianta: trequejañí
estudiante: trequejanó
estudiar: sisastrar, trequejenar
estudio: trejunó
eterna: delta
eterno: deltó
evaluar: amolelar, randar
Evangelio: Embeo
exagerar: barrequerar
excelente: baril
excelentísima: uschí
excelentísimo: uschó
excremento: ñorda
existencia: charniquí, ochibibén
existir: sinelar, socabar
exquisita: balbalí
exquisito: balbaló
exterior: abrí
extranjera: palatuñí
extranjero: palatuñó
extraña: corbí
extraño: corbo
extremar: escarfilar
extremo: uchua
fábula: jinobla
facultad: sila
faja: justiñí
falda: barruñí
falsa: singallí
falsificar: calabear
falso: singaló
falta: visaba
faltar: nabelar
fallar: farrijalar
fallecer: espichar, merar
fama: uluga, chimuclañí
familia: suetí, uluyilia
familiar: romañí
famosa: pachiriñí
famoso: pachirimó
fanfarrón: balcojuné
fantasía: barbalé, urdiñí
fantasma: mengue
farmacia: tuní
fatiga: canrí, duca
favor: furuné
fea: fañí
febrero: ibram
feliz: lachí, zaché
feo: chorré, fané
feria: chandí
festejo: ulaquín
festín: busonquí
festividad: ulaque
fiar: jerballar
fiebre: tati
fiesta: ulaque
fila: darí
filo: chirdé
fin: vuque
fina: sorabí
final: anda
fino: sorabé
firmamento: charó
fisonomía: chichí
flaca: ziriardí
flaco: ziriardé
flauta: pajandía
flor: zujemía
florida: zujimí
florido: zujemió
folio: godogloplé
follar: chingar
forastera: abertuñí
forastero: abertuné
formal: sorimba
fornicar: chingar
forrar: remollar
fortaleza: silisqué
fortuna: balbalipén
fosa: cobirí
foso: germó
fragancia: bue
fraile: erajay
freir: ajeriar
frenar: solibar
frente: mamuí, sentallí
fresa: murí
frío: jir
frontera: mixa
fruto: mibao
fue: chaló, sinaba
fuego: yaque
fuente: algeñiqué
fuera: abrí, baltrabé
fuerza: sisla
fuga: chapescañí
fugar: najabelar
fulana: chumascoñí
fusilar: arcoprindar
gafas: anclisó
galán: sintrabó
galápago: arrecocheponché
gallina: cañí
gallo: basnó
gamberrada: chana
ganadero: chalán
ganado: bragias
ganancia: mibao
gandul: alcarrán
gangosa: nacreñí
gangoso: nacrenó
ganzúa: clauca
garabato: garabó
gargajo: chiotá
garra: ñai
garrapata: gañarrapia
gastar: gastisardar
gasto: gastijén
gata: machicaí
gato: perpiché
gemir: golar
generación: ratí
generoso: juncal
genio: alialí
gente: sueste
gitana: zincallí, callí, cá
gitano: zincaló, caló, 
globo: glerú
gloria: chimucañí
gobernador: chinobaró
gobierno: grobelén
golondrina: andorí
golosa: charabarí
goloso: charabón
golpe: chirlo
gorda: chullí
gordo: chulló
gordura: chullimí
gracia: sandunga
grande: baré
grandemente: trambarén
granero: malabai
granja: sosí
granuja: charrán
grasa: putrichí
grillo: chiribito
grulla: cartaya
guapa: berjí, surdiñí
guapetón: matojernú
guapo: berjé, surdinó
guarda: aracate
guardar: aracatear, ujarelar
guardián: aracatano
guasa: baya
guisado: geribao
guisante: jeril
guisar: geribar
guitarra: bajañí
gusano: quirmo
gusto: pesquibén
haba: bobí
haber: ardicar
habichuela: quindía
habitación: alquerú, queli
habitante: talorante
hábito: beda, talorí
hablador: araqueranó
habladora: araquerañí
habladuría: bachijuñí
hablar: acarabear, chamullar
hacer: aquerar
hacia: palal
hacha: tescharí
halcón: jiquino
hálito: alban
hallar: berjar, alachar, baluchar
hambre: bocai, boquí
hambrienta: boquiñí
hambriento: boquinó
harina: jaroi
hasta: disdé, yesquí
haya: berján
hebilla: chumiaja
hecho: querdí
hedor: fullé, salipén
herbazal: llaván
herir: chinelar
hermana: penchí
hermanastra: pasplanorí
hermanastro: pasplanoró
hermano: planó
hermosa: balgisí
hermoso: balgí
herradura: iusmital
herrar: yusmiar
herrería: satarría
herrero: satarré
hervir: pejuchar
hidropesía: pañisalipén
hielo: jecó
hierba: cha
hierbabuena: chalachí
hierro: jach, sa
hígado: pajuara
higo: beon
hija: chaborí
hijastra: paschaborí
hijastro: paschaboró
hijo: chaboró
hijos: chorreles, churumbeles
hipócrita: singaló
historia: pendaripén
hocico: geta
hogar: sosimbó
hoja: parojí
hola: orí
holgazán: alcarrán
hombre: jeré, manu
homicida: churrinaró
homosexual: canco
hondura: omán
honor: pachibá
honra: pachiba
hora: cana
horca: borne, ustirí
hormiga: oripatí
horno: jaquestaró, sosimbó
horror: berrochi
hospedar: ustilelar
hostigado: ampuchao
hostigar: ampuchar
hotel: talona
hoy: achibé
hoyo: omán
hoz: deluné
hucha: ujurí
hueco: omán
huerta: vea
huerto: vea
hueso: cocalé
huevera: pelichí
huevo: anró
huir: chapescar, najabelar
humo: hua
hurto: choro
ídolo: dube
iglesia: cangrí
igual: manejo
iguales: tamuñí
iluminar: emblejar
ilusión: oropendola
impaciente: inorpachirry
importar: olacerar
impuesto: arjirú
incluir: chibelar
incontable: insoralé
incordio: brutellé
incorporar: vedelar
indicio: trail
indignado: ululé
indigno: bantojí
individuo: pailló
índole: orquide
inducir: enseclar
inexperto: biscondó
infarto: brutellé
infectada: telollí
infectado: teloló
infiel: dabrocó
Infierno: Benguí
ingeniero: chanaró
ingrata: suncallí
ingrato: suncaló
injuria: junquí
inmaculada: chachipira
inmaculado: chachipiró
inmortal: inmulela
inmundicia: cascañipén
innumerable: insorallí
inocente: jili, perdi
instruir: siscabar
inteligencia: chanelén
inteligente: perniqué
intentar: panchajañar
interesada: manguidoñí
interesado: manguindón
interprete: sarichipé
intestino: porriá
inudación: bujarrí
invierno: ven
ira: ajurjuñí
isla: beschí
izquierda: yesdra
jabalí: fracasó
jabón: sampuñí
jaca: grastí
jamás: nardián
jamón: balichón
jarro: belloso
jefe: brojeró
jeringa: agilé
Jesucristo: Tebleque
jilguero: pechivirí
jinete: gaitulo
jornalero: empirré
joroba: bujía
jorobada: brijindovía
jorobado: brijindovío
joya: challa
judía: bordají
judío: bordajú
jueves: cascané
juez: barander
jugador: ficaró
juicio: bardón
julio: ñuntivé
junio: nutivé
juntar: arredomar, catanear
junto: sumparal
juramento: sindicabaneto
jurar: sindicabalar
justicia: barsaní
juzgar: sarplar
la existencia: arat
la muerte: mují
labio: sonsí
labor: trocané
ladrillo: ulagoné
ladrón: choraró, randé
ladrona: chorí
lagartija: bejarilí
lagarto: bejarí
lago: chenopañí
lágrima: bielima
laguna: chenopañí
lamento: orobo
lamer: charabar
lana: jorpoy
lanzar: abistuar, bucharar
las: ar, as
lástima: canrea
látigo: chupiní
lavar: malipiar
lavativa: agilé
lazo: trajata
lealtad: jurispén
lector: laranó
lectora: larañí
lectura: nacardá
leche: cheripí
lecho: cheripén
lechoncillo: balorró
leer: libenar
lejos: aluné, andolaye, dur
lengua gitana: chipicallí
lengua: chipí
lenta: estrongerí
lenteja: arité
lento: estrongeró
leña: cas
leñador: castoberó
león: bombardó
lepra: zarapia
les: os
letras: lirestré
levantamiento: ardiñelo
levantar: vedelar
ley: echastra
leyenda: nacardá
liar: argilar
libertad: li
libertador: mestenaró
libre: techarí
librillo: lel
libro: armensallé
licor: liniari
liebre: soljía
liendre: churrillé
lienzo: bostán
límite: terrepleco
limón: berrechí
limonero: berrechino
limpiar: alipiar
limpieza: alipipén
linaje: ratí
línea: nevelí
lirio: jililé
lista: sarmuñí
listo: sarmuñé
lo cual: ma
lo que: ma
lo: o
loba: yerí
lobo: orú
loca: chalaa
loco: chalao
lodo: chiqué
lograr: tablear
lomo: dumén
los: ler, os
luego: yescotria
lugar: sinando, sistano
lujo: majoré
lumbre: dut, yaque
luna: chimutrí
lunes: lemitré
lustre: postín
llama: eta, yaque
llamar: araquelar
llanto: orobo
llanura: tariqué
llave: clauchí, clichí
llaves: aellas
llegado: abillaó
llegar: abillar, achorgornar
llenar: ucharelar
llorar: orobar
llover: brijindar
lluvia: brijinda
lluviosa: brijondayí
lluvioso: brijindoy
macho: maché
madero: condarí
madrastra: pasdaí
madre: bata, chinday, daí
madrecita: maita
madrina: batorrí
madroño: jamachurí
madrugada: claricó
maestra: duquedí
maestro: docurdó
mal: panipén, bastal
mala persona: juntún
mala: chorí, tuyallí
maldecir: solajar
maldición: olajay
malo: choré, tuyaló
maltratar: caquerar, guindarar
manantial: jañí
manca: miza
manco: mizo
mancha: quichardila
maniática: barllí
maniático: barlú
manifestación: quelibén
manifestar: vear
mano: ba
manta: uchardó
mantel: tablante
mantequilla: quir
mantón: ochardó
maña: albirijí
mañana: callicó
mar: pañibaró
maravilla: ciba
maravillosa: cibayí
maravilloso: ciboy
marca: paterán, simachí
marchar: pirar, nacar
maricón: bujendí
marimacho: manusardí
marrana: balí
marrano: balí
martes: guergueré
martillo: currando
marzo: quirdalé
más: bus, buter, ta, tamí
mascar: dambar
masticar: dambar
masturbación: bajanedrí
matadero: malabardó
matador: marardó
matar: marar, tasabar
matón: butejernú
matorral: arluchí, buré
matrimonio: corballé
matrona: chinderí
mayo: quindalé
mayordomo: barolacró
mazo: gardó
me: mangué
medianoche: pasrachí
medias: solebá
medicina: chocoromí
medida: bea, ran
medio: paque
mediodía: pascallicó
medir: melalar
meditar: orobrar
mejilla: chomé
mejor: fetén
melancólica: mulañí
melancólico: mulanó
melena: bachirdoy
melocotón: perpeló
melón: sungló
memoria: enjallé
mendiga: chorobí
mendigar: mangar
mendigo: choror
menear: bellopear, chalabear
meneo: bellopio
menos: bus, mendesqueró
menstruación: arate
mente: suncaí
mentira: trola
mentirosa: bulera
mentiroso: bulero
mercado: chandí, masqueró
merced: furuné
mérito: ocherito
mes: chonó
mesa: sallé
metal: arispejal
meter: chibelar
mi: mangué
mí: men
mía: men
miedo: arasnó, canguelo
miedosa: casñí
miedoso: casñé
miel: aguí
mientras: mirinda
miércoles: siscundé
mierda: ñorda
migaja: bedora
mil: jazaré, mile
milagrera: ciborí
milagrero: ciboró
milagro: cibo
millón: tarquino
mina: chijaurí
mío: men
mirador: discandisqueró
mirar: diar, diquelar, endicar
misa: mijate
misericordia: canrea
mismo: manejo
mismos: tamuñí
misterio: arcojuné, cibo
mitad: macara, paque
mocita: chai
moco: costunaca
mocosa: costunacayí
mocoso: costunae
mochila: peltraba
moderna: nebí
moderno: nebó
mojar: chobelar, jodorrar
moler: marabear
molesta: trajatayí
molesto: trajatoy
molinero: esianeró
molino: asía, esián
momento: sarmuñante
mona: sichí
monaguillo: sichaguilló
mondadura: bobé
moneda: estrongrí, rundí
monedero: quisobí
monja: erajundí
monje: erandié
mono: sicho
montaña: bur
monte: toberjelí, bur
montón: trabojo
moquero: fazo
moquita: jasañí
mora: corajayí
morar: socabar
moro: corajay
mortal: mulelá
mosca: machá
moscón: machín
mosquito: finguelé
mosto: mostagán
mota: chirirí
mote: avernaó
muchacha: bedorí
muchacho: bedoró
muchas gracias: garapatí
muchedumbre: chusma
mucho: baribú, buté
muda: musilí
mudanza: purrubipén
mudo: musilé
muela: chimulagia
muerta: mullí
muerte: meripén
muerto: muló
mujer: gachí, rumí
mula: almifora
mulata: esprejañí
mulato: esprejanó
mundo: sundaché
muñeca: mastronjí
muñeco: mastronjó
murciélago: coligote
murmurar: chumasquear
música: singa
muslo: custisangulo
muy: but
nacer: ardiñarar
nacimiento: ardiñipén
nación: esichén, chim
nada: chi
nadar: chapaletear
naipe: espillante
nalga: napa
naranja: chiringa
nariz: nacrí, ñacle
narración: penclarí
narrar: penclar
natural de: ardiñoral
navaja: churí, serdañí
navajera: serdasquinerí
navajero: serdasquineró
navidad: molchibé
negar: neguisar
negra: gallardí
negro: gallardó
ni: na
niebla: cohedí
nieve: jibé
ninguna: caiqué, necaulí
ninguno: caiqué, necaulé
niña: chabí
niño: chabal
no gitano: busnó
no: na, ne
noche: arachí, rachí
nombrado: acnabao
nombrar: araquelar, asnabar
nombre: acnao
nosotros: amangué
novena: esnetí
noventa: esneté
noviembre: ñurdicoy
novillo: burechunó
nube: paré
nuera: sasí
nuestra: nonriá
nuestro: amarí, nonrió
nuestros: amarias
nueva: nebí
nueve: nebel
nuevo: nebó
nuez: pendajiminí
número: jin
numeroso: butré
obispo: erajailolé
obra: trocané
obrera: curarí
obrero: curaró
obtener: argirar
oca: papí
océano: pañibaró
octava: otorí
octavo: otoró
octubre: octorba
ocultar: ucharar
ocupar: ucharelar
ochenta: otordé
ocho: otor
ochocientos: ortogrés
ofender: ultrasijarar, ajuncar
oficial: currial
oficio: curripén
ofrecer: diñelar
oido: cané, jumelo
oir: junar
ojalá: oropatialá
ojos: clisos
oler: jinglar
oliva: zetalla
olivar: urucal
olor: jingloy
olvidar: chanorgar
olvido: chanorgú
olla: arrujilé
ombligo: trunchá
once: yesdeque
opresor: pandelaro
oprimida: pandelañí
oprimido: pandelao
oprimir: pandelar
oración: ocanajaimia
orar: bedar, ocanar
oratorio: fermeniché
orbe: glorinqué
orden: arquisimí, pacuarí
ordenador: dichabaró
ordenar: abistenar
oreja: can
orgullosa: arjuñí
orgulloso: arjunó
oriente: boctaró
orificio: bu
orilla: ocanilla
orina: mucló
orinar: jañar
oro: sonacay
oscura: bruqilí, orunañí
oscuridad: turonijé
oscuro: bruquilló, oruné
otra: jetra
otro: jetro
oveja: jembí
padecer: brichalar, urguiñar
padrastro: pasbatú
padre: dada, bató
padrino: batorré
paga: plasarí
país: chim
paja: banjarí
pájara: chiriclí
pajarito: ujarre
pájaro: chiricló
palabra: vardá
palacio: chuqueló
paleta: galillí
paleto: galilé
paliza: estiva
palo: basté
paloma: custañí, gobarí
palomar: custañiqué
palomo: gobaró
palpar: pajabar
pan: manró
panadera: manrrelorrí
panadero: manrrelorró
pantalones: jalares
pañal: dicló
paño: chan
pañuelo: triqué
papel: yulí
para: pa, somia
parada: desquiño
paraje: sistano
parar: sinabar
pared: umú
parienta: cachicallí
pariente: cachicaló
parir: chindar, uchabar
párpado: recataré
parroquia: cambroquía
parte: aricata
partera: chinderí
partición: aginé
partido: tandal
partir: aginar, aricatar
parturienta: chinderiñí
pasa: betesumí
pasado mañana: callicate
pasaporte: atrojipú
pasar: chasar, entrasaurar
Pascua: Ciria
pase: mola
pastor: durotuné
pata: pachimachí
patata: bitagimé, bujarí
patria: chim
patriarca: chejaró
peatón: epusifiqué
pecado: dojí, gejostré
pedazo: muciquí
pedernal: yequebar
pedir: mangar
pedo: balorrí
pegar: estivar
pelada: simpalomí
pelado: simpalomé
peldaño: yescaliche
pelea: chicarela
peligro: paripén
pelo: bal
peluca: baluca
pelusa: rejí
pena: duca, puñí
penar: curdar
pendientes: challas
pene: cá, quilé
penetración: pesquí
península: pasbeschí
penitencia: daquinañí
pensamiento: suncaí
pensar: orobrar
peña: bar
pepinillo: gorqué
pequeña: chimí
pequeño: chimó
pera: bronda
peral: brondó
percibir: ustilar, apicharar
percha: alcandora
perder: najabar, orajabar
pérdida: najab
perdón: mecó, trunjó
perdonar: estomenar
perdurable: berable
perecer: caquivar
peregrinar: pergolear
perito: chanaró
perjudicar: caquerelar
perjuicio: choro
permanecer: busmucar
pero: tamí
perra: chuquelí
perro: chuquel
persegir: plastarar
persignarse: persimacharse
persona: elabel
persuasión: coba
perversa: mallorrí
perverso: malorré
pescadería: machumí
pescado: maché
pescador: machamó
pescar: machar
pescatero: machoraró
pescuezo: canró
pesebre: olibal
peseta: lua
peso: meerta
pestaña: sosimbré
pestilencia: salipén
petición: manguelo
pez: maché
pezuña: inera
picar: punsabar
pico: pinsabó
pichón: custañiló
pie: pinré
piedra: bar, barrandañí
piel: pelí
pierna: jería, pachimachí
pillo: charrán
pimienta: pispirí
pimiento: pisjundí
pino: sintirí
pintar: costanear
pintor: costanó
pintora: costañí
pinza: orbriza
pinzas: cachá
piña: monda
piojo: chucao, gaó
piropo: rebidraque
pisadas: calcas
pito: guajanó
placer: asuseloy
planeta: uchurgañí
plantear: chantear
plata: lama
plazo: macaró
pliegue: argostín
plomo: dojapuy
pluma: porumí
población: ancha
pobreza: chororipén, erdicha
poder: aislar, arcilar, ezor
poleo: polinché
polvo: pracó
pólvora: jurdí
pollo: basnó
pompa: majoré
poner: chitar, 
por debajo: ostelé
por qué: sosqué
por: on, per
porque: sos
porquería: buñigoní
pórtico: nardichola
posada: mesuna, talona
poseer: aracatear, terablar
postrar: chibandar
potencia: astisiripén, sila
potente: silaró
potestad: ezor
potra: goroní
potro: saullo
pozo: jibilén
precipicio: luchipén
precoz: chirijimayí
predecir: bajiar
pregunta: pruchañí
prensa: trensa
preñada: arañí
preñez: cambrí
preparar: chitelar
prepucio: cipote
presa: estardí, sinastrí
presencia: asiapí
presentar: delalar
presente: debal
presidio: caltrabó
preso: arinatro, sinastro
presta: sarmuñí
presto: sarmuñé
pretendienta: manguidoñí
pretendiente: manguindón
prima: brotomuchí
primicia: brotamuchí
primo: brotomuchó
primogénita: brotochindí
primogénito: brotochindó
princesa: manclayí
príncipe: mancloy
prisa: salmoní, singo
prismáticos: anclí
procrear: abatanar
producir: acabelar, brojanear
producto: brojañén
profecia: bají
profesión: curripén
profeta: bajalí
profetizar: bajiar
profunda: gorí
profundizar: enquerar
profundo: goró
progenitores: batuces
promesa: prensallé
prontamente: sigo
propio: manejo
proteger: bomborar
provecho: panripén
proveer: maturnar
prudencia: drun
prueba: bujoní
púa: jarrí
pública: pucañí
publicar: najibelar
público: pucanó
puchero: veró
pudor: lacha
pueblo: gal, garó, gau
puente: perpeñí
puerca: balí
puerco: baliché
puerta: bundal
puerto: burdó
puesto: sinando
pulga: pajummí
pulgar: langustí
pulmón: buqué
punta: esogié, uchua
punto: buque
puñal: barañí
pupitre: cafidí
pura: chachipira
Purgatorio: Tumbardó
puro: chachipiró
púrpura: lalané
puta: lumí
putero: pirandón
puto: eriñé
que: sos
quebrantar: asparabelar
quebrar: asparabar
quedar: sinabar
queja: sasteja
quejica: sastejayí
quemada: jacharí
quemado: jacharé
quemar: jachar
querer: camelar
querida: tronga
queso: quirá
quien: coin
quienes: coines
quimera: chinga
quince: panchedequé
quinta: pancherí
quinto: pancheritó
quizá: astís
rama: senque
rana: damba
rancio: aranfí
rata: carmuñí
ratón: carmuyón
raya: nevelí
razón: bardón
realidad: chachipén
recato: parrablé
recelar: canguelar
recepción: sundiné
receptor: alollaró
receptora: alollarí
recibir: ustibar, enjibar
recibo: ustiló
reclamo: trebú
recoger: arrobiñar, ustibar
recordar: araperar, ojarar
recortar: rechirdar
recostar: chitadomar
recuerdo: enjallé
red: rechibí
redención: mestepén
redituar: brojanear
redondo: borondo
reembolsar: poquinelar
referir: penar
refrán: rejelendré
refrescar: jilar
regalo: diñipén
regar: muchobelar
región: chim
regla: arquisimí
reglamento: echastra
regocijar: alendar, asaselar
regreso: bae
reina: beluñí
reino: chim
reir: guirar, salar
reja: recañí
relámpago: malunó
relativo: ma
relegar: chanorgar
reloj: parlo, sorlo
remedio: chocoromí
remiendo: muciquí
remisión: mecó
rendir: chibandar
renegar: renicar
renta: brojañén
reñir: chicarelar
repartir: sicobar, ajinar
repasar: renaquelar
repaso: renaqueló
reposar: sobelar, sornar
reposo: paratute
reprimir: sarterelar
reprobar: sardenar
rescate: mestepén
resguardo: ustiló
respetable: rebinable
respeto: bajín
respiración: arispén, resuñarí
respirar: arispar, resuñar
resplandor: yaque
responder: brudilar
respuesta: brudila
resucitar: ostinar
retablo: chalorgar
retorno: bae, truta
reunido: acatao
reunión: catescá
reunir: acatar, arredomar
rey: beluné
rezar: dabardar, ocanar
rica: balbalí
rico: balbaló
riesgo: paripén
rígido: sicabao
rincón: esicón
riña: bersejí
riqueza: balbalipén
robar: chorar
robo: choro
roca: bar
rociar: chobelar
rocío: ucho
rodilla: chanclí
roer: jamelar
rogar: brichardilar
rojo: lolló
romero: rumijeló
romper: parabelar
ropa: talabosa
ropaje: dicló
Rosario: Dabastró
rostro: chuchí
rotura: asparabañí
rufián: engibacaire
sábado: canché
saber: chanar
sabiduría: siscababén
sabio: chandé
sacar: sicobar
sacudir: chilar
salamanquesa: beribicha
salar: alonar
salchicha: gojí
salero: sardioqué
salida: bundal
salir: sicabar
saliva: chiotá
salivar: chiotar
saltar: salmuñar
salto: salmuñí
salud: estipén
saludar: aspasar
saludo: aspasarí
salvar: berabar
Salve: Berarbé
sana: sastí
sanar: canisarar, sastar
sandía: sunglí
sangre: arat
sanguijuela: espirabí
sanidad: estipén
sano: sastó
santa: majarí
santidad: manjarida
santo: manjaré
santuario: fermeniché
sardina: sarbañí
sargento: sará
sarmiento: estorey
sarna: zarapia
sarnosa: zarapiá
sarnoso: zarapiao
sastre: zarazatán
sazonar: alonar
sebo: chuchipón
sed: japillí
seducir: pesquilar
segar: chinelar
según: andiar
segunda: duisquera
segundo: duisqueró
segura: techarí
seguramente: aromalí
seguro: techaró
seis: jové
selva: resí
sello: atronjí
Semana Santa: Pachandrá
semana: dramia
semejante: timuñó
senda: drungí, feda
sentar: bestar
sentencia: sapla
seña: simache
señal: simachí
señalar: uchar
señor: erasñó
señora: erasñí
septiembre: jentivar
séptima: esterí
séptimo: esterdó
sepultar: archelar
sepulturera: archelarí
sepulturero: archelaró
ser: quesar, sinar
serio: sorimbo
serpiente: sarapé
serrana: orotuñí
serrano: oroturné
servir: archabar
sesenta: joventa
setenta: esterdí
sexta: zobía
sexto: zobio
sí: oción
si: sata, unga
sidra: peñacoró
siempre: gajeré
sien: sierra
siesta: sorní
siete: ester
siglo: gre
signo: simache
silencio: soniché, zoniché
silla: bestí
sin: bi
sinagoga: socretería
sino (destino): sustirí
sino: tamí, unga
sitio: gal
sobar: bajambar
sobrar: sobresarelar
sobre: opre
sobrevenir: opreabillar, sabindar
socorrer: agiler
sofocar: buyelar
sol: cam
solamente: falcoré
soldado: seroy
sólida: silñí
sólido: silné
soltera: colcorrí, gellí
soltero: colcorré, geló
sombra: parín
sombrero: chapirí, estache
sonar: simbelar
sonido: sen
sopa: jibicha
soplón: bucanó
soportar: argurar
sorda: cajuncaí
sordo: cajuncó
sorteo: sustirí
sostener: ardiñelar
su: sun
subir: ardiñar
suceder: chundear
suceso: chundañí, querdí
sudar: sodimiar
suegra: ñuñí
suegro: ñuco
suelo: chén
sueño: sobindoy, sordindoy
suerte: sustirí
sufrimiento: brichalipén
sufrir: brichalar, urguiñar
sujetar: sarterelar
suministrar: maturnar
superior: baré, furré
súplica: brichardila
surtidor: jañiqué
suspiro: jimiloy
susto: dra
suya: desquerí
suyo: desqueró
tabaco: truján
taberna: tasca
tabla: pal
taco: bartraqué
tal: andoba
talego: gonó
también: trasmitó
tambor: guajá
tan: tran
tanta: trincha
tantear: chantear
tanto: trinchí
tapadera: tapisalera
tapar: ucharar
tapia: yustiqué
tardar: tasabiar
tarde: tasalá, tasardén
taza: dubela, subulmí
te: tacué, tucue
té: ten
tecla: pajabí
técnico: chanaró
teja: oleña
tejado: trasardó
tejer: alaquiar
temblar: dajirar, jirear
temer: canguelar
temor: arasnó, canguelo
tempestad: buró
templo: altana, cangaripé
tenaza: madraga
tenebrosa: bruquillí
tenebroso: bruquilló
tener: tenelar, abiyelar
tentación: bajambarí, chungalipén
tentar: tensiarar
tercera: brodelí, trincherí
tercero: brodeló, trincheró
tercia: trina
tercio: trino
terciopelo: vellido
terco: panchariqué
ternera: chajurí
ternero: chajurú
terraza: varidi
terremoto: jolilimotó
terreno: chén
terror: dal
tesoro: manchín
testículo: albairé
testículos: janrrelles
testigo: dicharó, machiró
testimonio: machiriá
teta: chepó, chuchaí
ti: tacué, tucue
tiempo: chiró, dané
tienda: cachimaní
tierra: chén
tijeras: cachá
timo: penchicarda
tinaja: lucharré
tinta: arantí
tintero: terindoy
tiña: tel
tirano: pandelaro
tiritar: jirar
tocar: pajabar
tocata: pajabí
tocaya: bajambaya
tocayo: bajambayo
tocino: balibá
tomar: trinquelar, ustibar
tomate: lolé
tono: didiló
tonta: bombañí
tonto: bombané
toque: pajabañí
tormenta: buró
tormento: acharé
toro: burel
torre: alta
torrente: sisní
torreón: fermenicha
torrija: filichija
tórtola: gobarey
tos: chicatelu
toser: chicatelar
tostada: filichija
trabajar: currelar
trabajo: currelo, trocané
traducir: destebrechar
traer: acabelar
tragar: trajelar
tragón: jallipón
tragona: jallipí
traidor: singaló, suncaló
traidora: singallí
trama: trajata
trampa: bitijí
tras: palal
trasero: bullaté
trasladar: chasar
trece: trindeque
treinta: trianda, sinebo
tren: birdoche
tres: trin
trigo: guí
Trinidad: Trimurtí
triste: fané
tristeza: charaburí
triunfar: garlear
trompeta: pumetelí
tronar: luriandar
tronco: tronfaró
trono: bestí
tropezar: chondelar
trueno: luriandó
trueque: garda
tú: tacué
tuerta: cocorrí
tuerto: cocorroró
tumbar: combar
tumulto: arjulejá
túnica: furí
turbación: darañalí
tuyo: tucue
última: egresitoñí
último: egresitón
ultrajar: achangar
una: yequí
ungir: ampiar
única: beiquí
único: beicó
universo: sundaché
uno: yequé
unos: yeques
untar: ampiar
uña: turra
usar: daracar
uso: daraco
usted: ostré
uva: draca, traquía
vaca: bechuñí
vacío: liché
vagabunda: bochacayí
vagabundo: bochacay
vagina: beo
vagón: urdón
vale: mola
valentía: soschí
valiente: terné
valor: chiporró, ternariló
valle: butrón
vanidosa: bujiñí
vano: bujiné
vaquilla: chajurí
vara: ran
varón: manu
varonil: manusaló
vaso: escarqué
vecino: algomagó
vehículo: berduñí
veinte: bin
vejez: purañí
vela: mermellí
veleta: diqueleta
velón: dundiló
vendar: pandrebar
vendedor: bisnaró
vendedora: bisnarí
vender: binar, bisnar, venar
veneno: drao
venerar: bujirar
venido: abillaó
venir: abillar
ventana: berdacuñí, bisna
ventura: bisnajura
ver: apicharar, endicar
verano: yacunó
veraz: chipendí
verdad: chachipén, chamuchí, chipé
verdadera: chachipení
verdadero: chachipenó
verde: bardorí
verdoso: bardroí
verdugo: anaoz
vereda: oroscaña
vergüenza: lacha
vertedero: furgoñí
vestimenta: talaror
vestir: talarar
veta: busjí
vez: begai, chiró
viajera: mostarbañí
viajero: mostarbán
vianda: maas
víbora: verbiricha
vida: chanigué, puchén
vidrio: dinastré
vieja: purí
viejo: puré
viento: barbán, gris
vientre: trupo
viernes: ajoró
viga: condarí
vigorosa: sisllí
vigoroso: sisló
vileza: bachurrí
vinagre: molsoré
vino: mol
viña: eresí
Virgen María: Tamara
virginidad: pachí
virtud: sila
virtuosa: silarí
virtuoso: silaró
vista: discandí
visto: dicaito
viuda: pespirincha
viudo: pespiriucho
viva: apuchelí
vivir: apuchelar
vivo: apucheló, apucherí
vocablo: lao
vocear: golar
volar: balogar
volúmen: bacamún
voluminoso: barial
voluntad: oropendola
vosotros/as: sangué
voz: golé
vuelta: truta
vuestra: jirí
vuestro: jiré
y las: yas
y los: yes
y: ta
ya: acaná
yegua: grasñí
yema: perma
yerno: sasú
yesca: yaspardí
yeso: alfor
yo: man, mangué, manguí
yunque: trujé
zapatero: chumajarró
zapatilla: alcorque
zapato: calco, tirabañí
zarza: berdolaya
zorra: andándula
